##..##..##..##
##2G..T1M2....
....####..1G##
##M1..R13G..##
##3S##..##M2##
##1S2SM2##..##